W W W W W W W W W W W W W
W - - - - - C - - - - - W
W - E - - C H C - - K - W
W - - - - - C - - - - - W
W - - - - C - - S - - - W
W H - - H - - - - - - - W
W - - - H - - - B - - - W
W C C - H - - - - - P - W
W C C - - C - - - - - - W
W C C - - C - - - - - - W
W C C - - C - - - - - - W
W W W W W W W W W W W W W