W W W W W W W W W W W W W
W - - - - - - - - - - - W
W - - - - - S - - - - - W
W - B - - - - - - - - - W
W - - - - - - - S - - - W
W - - - - - - - - - - - W
W - - - - B - - B - - - W
W - - - - - - - - - - - W
W - S - - - - - - - - - W
W - - - - - B - - - - - W
W P - - - - - - - - S - W
W W W W W W W W W W W W W